15,25
+++++++++++++++++++++++++
+                       +
+ +++++++ +++++++++++++ +
+ +     + +           + +
+ + +++ + + +++++++++ + +
+   +   +   +       + + +
+++++ +++++++ +++++ + + +
+     +       +     +   +
+ +++++++++ +++++++ +++++
+         + +         + +
+ +++++++ + + +++++++++ +
+       + + +         + +
+ +++++ + + +++++++++ + +
+     +s    +g        + +
+++++++++++++++++++++++++
